#Example: Large parts of Africa and south east Asia
tropical = {
	# Minotauria
	406 2215 4271 409 415 4294 2311 2312 413 4290 4337 149 428 321 126 163 320 2310

	#South-East Equestria
	895 889 2528 885 367 892 2539 2532 2538 924 930 880 925 2669 2537 4625 920 922 921 2530 2500 923 883 2533 893 886 2014 927 366 347 1110 230 4548 368 4150 227 229
}

arid = {
	4171
	
	#Equestiran Desert
	877 867 4635 876 2666 888 4629 4646 2619 862
}

arctic = {
	# Northern Griffonia
	4143 4144 4241 22 20 5 16 4164 21 315 4113 38 1776 1930 4123 1977 2 3 31 25
	4152 39 27 29 28 32 30 1961 1842 7 4124 1834 33 309 313 37 34 274
	2953 284 463 2197 2416 2410 287 464 2417 4114 17 4145
	
	# Penguins
	371 1003 991 2588 2590 1004 909 912 2604 370

	# Bears
	2605 2602 2004 2510 2502 2598 1813 2007 2804 2830 806 808 2841 2889 811 814 2512
	
	#Nova Griffonia
	2581 998 2559 1002 2580
	1105 969 2584 993 2592 2585 2564 2008 960 2563 2595 
	
	#Crystal Empire
	1814
	
}

#Example: Most of Europe north of med.
mild_winter = {

	#South-East Griffonia
	1066 2434 2357 1075 1065
	
}

#Example: Inland Europe & Scandinavia
normal_winter = {

	#Riverlands
	2429 2441 2444 4685 4692 476 2369 2361 478 4681 1076 4554 2427 2355 1964 2431 475 1965 474 2420 473 4265 2352 1972 2419 1077 1064 2358
	2353 2443 470 2418 2415 304 2407 290 299 283 4543 1941 4247 298 467 2409 1081 1068 1070 4547 1078 4551 219 2367 2433 456 480 1054 472 2360
	465 4679 1973 215 1060 1055 4683 718 1780 1061 4689 1079 4264 2421 302 1777 289 4115
	2359 2432 2437 2422 479 1753 307 1083 4267 1071
	
	#griffonia
	303 258 4525
	
	# Blackhollow
	4531 4179 422 424 159 4301 4532
}

#Example: Russia & Lappland
severe_winter = {
	# Northern Griffonia
	4143 4144 4241 22 20 5 16 4164 21 315 4113 38 1776 1930 4123 1977 2 3 31 25 4152 39 27 29 28 32 30 1961 1842 7 4124 1834 33 309 313 37 34 274 310 1958 4258
	2953 284 463 2197 2416 2410 287 464 2417 311 1752 4261 17 4145 2752 376 4118 4146 4153 2426 4159 4160 4162 4161 285 4157 2425 4148 275 4248 4249
	308 4250 4243 294 1959 4260 4254 4259 1955 306 4262 2754 1963 4553 1940 11 19 18 238 4372 4378 4120 4380 4119 23 35 36 373
	
	#Griffonia
	4155 4172 2370 462 2447 2304 1744 156 443 158 4156 4128 165
	
	#Riverlands
	1957 1754 4122 4255 1778 293 295 2423 4147 4245 4251 4246 4114 4253 1956 4117 314 4545 4544 4252 300
	296 4263 4256 301 4178 1045 4690 4686 1082 4688 2354 2428 1962 4154 4266
	305 4687 440 1069 1755 2442 4222 217
	1782 1067 1966 477 4169 4556 
	2366 1781 405 1970 1063 2351 4339 2365 719 714 1783
	716 4684 1080 
	
	#Greyclif
	4257 312 4129
	
	# Penguins
	371 1003 1805 370 991 2588 2590 1004 909 912 2604 1804 1806

	# Bears
	2605 2602 2004 2510 2502 2598 1813 2007 2804 2830 806 808 2841 2889 811 814 2512 1808
	
	#Nova Griffonia
	2581 998 2559 1002 2580 982 2567 990 984 2569 971 2589 2569 2572 2568 2571 1008 908 2566 2565 2570 1005 2591 985
	1105 969 2584 993 2592 2585 2564 2008 960 2563 2595 1104 986 2582 2670
		
	#Crystal Empire
	1814
	
	#Equestria
	2519 915 914 2506 2486 2536 913 917
}

impassable = {
	2426 1173 1779 1781 1782 1783 1784 1785 1786 1787 1788 1789 1790 1791 1793 1794 1795 1796 1797 1798 1799 1801 1802 1803 1804 1805
	1806 1807 1808 1810 1811 1812 1814 1950 2194 2200 2251 2334 2608 2740 2425 2936 3415 3416 3417 3418 3419 3590 3591 3592 3593 3594 3595 
	3596 3597 3598 3599 3620 3621 3622 3623 3624 3625 3626 3427 3628 3629 3630 3631 3632 3633 3634 3635 3636 3437 3638 3639 4146
	4153 4154 4155 4156 4157 4159 4160 4161 4162 4167 4168 4169 4170 4172 4178 4179 4276 4321 4322 4328 4400 4401 4402 4403
	4522 2129 4569
	4657 405 1080 1744
	#Minotauria
	4309 4338 4177
	#Nova Griffonia
	2571 2568 908 1008
	#Equestria
	2486 2506 4630 2009 2491 2536
	
	#Olenia
	2661 826
	
	#Changelings
	2931
	
	#Zebrica
	1151 2280 4444 2048 2134 4151 2440
}

mild_monsoon = {

	2730 2731 # Northern Australia
}

normal_monsoon = {

	1996 1995 1235 1993 1992 1994 1991 1236 # Pacific Ocean islands
}

severe_monsoon = {

	1950 4401 4400 1787 2740 1789 2251 # Wastelands
}

equator_y_on_province_image = 656