griffonia = {
	#Vedina
	2752 23 4110 250 252 4119 4380 251 4363 4362 249 372 4121 373 4120 376 4361 248 4377 4379 374 4365 4364 1978 369 1979 253 242
	#Herzland
	58 62 59 1759 235 236 237 1775 4371 1981 4142 4141 2997 4149 13 1 1858 1985 2994 6 26 48 1859 4523 12 14 50 1763 4524 15 41 1841 1983 1984 2963 254 2969 4526 4528 262 263 278 279 259 260 277 4538 270 1936 4534 9 4161 4163 49 1982 4165 272 273 770 1960 4535 35 36 2995 67 269 1937 1938 4536 167 256 2970 4527 4533 60 61 292 771 1771 291 2407 4542 78 80 1876 79 2957 2968 153 155 157 1952 4127 40 234 239 241 271 1770 206 257 258 303 1939 4525 294 4248 4249 275 276 1963 4242 4537 154 162 1318 1772 4529 168 265 4237 2406 2960 4236 1856 1974 2195 2208 1756 2198 4306 282 425 2405 45 46 47 1857 44 51 2993 2996 57 1758 2971
	#Verenia
	191 192 193 1953 4392 72 133 189 1880 233 4130 4373 4374 64 89 135 182 4125 65 87 88 181 1743
	#Cloudbury
	375 4378 4118 247 4367 245 246 4368 244 1861 4375 4372 4376 240 238 16 18 19 2953 243 4370 1860 4 10 8 11 1940 285 4553 2197 463 284 2416 4152 1961 287 464 2410 2417
	#Northern coast
	17 4145 4144 4143 4241 22 20 21 5 4164 4114 315 38 4113 39 7 30 32 28 27 4124 1930 29 1776 1977 4123 2 3 31 25
	#Hill Ponies
	1834 34 37 274 1842 33 309 313 4258 2754 1955 306 311 310 4148 1752 4260 4261 1958 1959 4243 4117 1956 4254 4259 312 4129 4257
	#Griffonstone
	165 1869 1870 1769 2424 2863 4240 166 1867 1873 161 1951 2998 4128 156 158 439 443 159 2370 2447 4532 160 2304 4531 422 424 462
	#Aquileia
	4390 188 77 1761 75 179 209 178 1745 180 190 195 4385 177 4389 70 71 74 185 184 91 94 1760 98 4383 95 85 84 2975 1742 96 2974 1762 83 81 1865 90 92 2967 96 2965 1744 1877 187 186 4388 1879 183 129 131 4173 129 1768 68 1872 76 1868 69 1866 93 1878 266 4369 4366 52 55 1931 2964 2972 54 1874 53 97 56 2973 86 82 99 264 2966 255 4238 4382 4381 100 66 1757 267 2956 42 2958 767 218
	#Western Riverlands
	308 314 4250 4246 4544 4545 290 299 467 2409 283 298 4543 1943 2199 2412 295 261 268 2961 4541 4245 4251 4253 300 4147 4252 296 2423 4263 289 1941 4115 4247 302 304 1777 1081 2415 2418 2419 2421 4264 4267 297 2408 4116 4244 281 2962 4539 280 1942 1944 4540 473 474 475 1965 2420 4265 1062 1072 1073 1971 2445 1059 1964 2430 2431 2436
    #Evi Valley
	286 1846 2201 2413 2749 4530 2205 2314 4305 4315 216 316 2300 4299 329 2299 4313 2305 4302 4304 4340 4314 288 1935 2414 4555 420 421 2202 2411 4558 232 466 469 231 468 471 2189 2363 382 437 444 1854 4297	442 455 1849 1855 378 411 235 438 441 2207 2309 4300 416 2348 2349 4293
	#Coast of Eler
    151 326 4310 331 2301 2303 2306 2307 4303 317 322 332 2212 4311 4312 409 415 4294 126 406 2215 2310 4271 149 428 413 4290 4337 142 163 164 320 321 144 145 146 2210 3003 414 2209 2213 2296 2297 4308 147 1773 4291 4341 319 1848 2298 323 327 2211 4335 318 377 417 2302 2313 4298 324 418 2308 4295 426 2206 4292 4296 419 423 2203 2204 4301 112 130 136 205 4112 174 194 203 4387 199 410 2753 4111 125 175 196 1853 2982 137 143 148 4174 4175 124 127 1247 2986
    #Karthinnia
    150 325 328 330 2746 110 1871 2978 4176 111 200 1774 4391 113 114 4386 141 198 1826 1827 1954 3000 1766 2991 3001 104 105 108 109 212 1862 102 103 1875 2992 4288 106 115 116 117 123 213 2977 2984 107 119 120 122 1933 2985 118 121 1934 2976 2983 101 429 2979 2980 2981 
    #Transfolinia
    73 132 134 2995 138 201 1828 1831 3002 152 1767 1864 4126 139 140 1765 4239 426 1747 2987 1851 2206 2988 173 176 197 202 204 
	4552 2755 207 208 221 1750 4384 172 171 170 169 211 1746 2989 2751 4557 214 210 4549 220 4559 333 4550 4560 2990
    #Southern Riverlands
    407 1065 2362 1074 1075 4691 478 1066 2357 2359 2434 215 465 1973 2353 2432 4679 2352 2361 2369 477 1067 1966 2366 4222 217 470 2360 4556 472 716 2367 2443 1076 1972 4681 714 1061 2355 2427 718 719 1780 4683 1063 1080 1970 4684 1055 1060 2351 2365 4339 
    #Eastern Riverlands
 	479 1079 2422	4266 301 4255 4256 293 1754 1778 4122 307 1083 1753 1082 4686 4688 305 1069 1755 2354 2429 2441 2442 440 1962 2428 2433 4554 4687 1045 1071 1077 2437 4689 4690 456 480 1064 1078 4547 1054 1068 1070 2444 219 476 2358 4551 4685 4692


}
equus = {
	#Pingland
	370 1003 1004 2590 2604 371 991 2588 998 1002 2580 2581 969 1104 1105 982 984 2569 2589 990 993 2584 971 2565 2566 2567 2570 909 912 2559 2004 2008 2598 2602 2605 808 2502 2510 2841 806 807 2889 2007 2804 2830
	#Yakyakistan
	1005 1006 2591 2592 959 960 2563 2564 2585 2595 987 1001 1007 2587 2593 904 958 2013 910 2015 2518 2562 2603 961 967 970 2601 989 992 2517 2599 2600 945 1813 2018 2503 2596 1011 2005 2017 1009 2594 2597 906 1010 2521 
	#Rocky Coast
	980 981 997 2573 2574 2575 985 996 2576 2577 2578 994 995 2572 2579 2582 966 986 2671 968 988 2586 1008 2016 2511 2670
	#Severyana
	964 983 1000 2012 2583 949 955 2554 911 963 2011 937 953 2560 944 965 2522 2561 942 943 2010 2550 2556 2639 947 2549 2555 224 2023 2558 950 952 956 962 946 2552 2553 948 951 2551 915 2519 2525 2526 2544
	#Equestrian East Coast
	957 2548 2557 891 897 941 954 2514 898 2509 2515 2547 899 902 2672 905 919 938 2531 940 2508 2524 481 936 2523 2543 901 933 2019 2545 890 932 2490 2546 2020 2529 2542 931 2489 2501 2540 
	#Aztlan
	878 2494 4631 4632 889 895 2496 4649 367 885 892 2528 848 2539 2644 4583 4598 850 930 2538 2643 4575 852 924 2623 2624 4572 4574 880 2532 2647 4579 925 2627 2628 2648 4570 4578 2622 2626 2669 4573 927 2014 2534 2537 4582 4625 854 886 920 921 2621 883 928 2516 2533 4580 922 923 2500 2530 2657 4576 893 2646 4581 887 2665 4627 888 4629 2497 884 2499 2616 4577 851 882 2667 4628 863 864 881 2492 2498 4643 4645 879 2642 4633 4644 867 876 877 862 2666 4635 861 2615 2618 858 2614 2668 4571 4648 860 2619 4641 4646 856 857 4647 853 4606 4634 4650
	#Inner Equestria
	875 973 2495 2606 1809 2504 2505 2625 896 900 914 2520 894 934 935 907 2483 2541 4626 913 916 917 918 939 903 2493 2513 2003 2006 2488 2527 870 874 2535 2607 929 972 2487 2507 2610 2617 859 866 2620 
	#Western Equestria
	855 926 2021 2641 4640 4642 868 2479 974 975 2485 4572 2022 2484 2609 844 976 978 4584 2611 2629 2630 849 2635 2649 2631 2632 2650 4585 977 2477 2480 2613 4637 865 2478 2482 4638 869 873 2476 4636 4639 871 872 2481 482 847 979 2612 2854 2928
	#South Olenia
	842 2633 2638 846 4590 4591 845 2651 2652 843 2634 4587 4588 4589 841 2653 2837 4594 2636 2637 2640 2662 839 2658 2659 4620 490 840 4593 4621 837 2661 2836 2883 4597 828 836 2814 2817 4595 4601 835 2819 2664 4599 829 2806 2818 4596 4614
	#North Olenia
	827 830 834 4600 2813 4603 4609 4611 823 2807 2812 4608 4610 491 2808 2809 2816 4607 4612 
	#Changeling Lands
	809 810 811 2927 814 2512 2826 4615 502 741 2935 2937 743 2803 2827 2833 2878 4616 744 745 820 2933 746 793 2820 493 818 831 2946 802 804 805 2822 2947 815 832 1116 2939 2243 2929 4605 801 803 2660 2811 2901 822 2815 2839 4617 747 821 2832 817 2945 4604 794 816 819 2824 2828 742 799 2934 796 797 2831 2900 2942 2943 748 795 813 2821 2941 800 2823 2825 2834 2805 2835 2838 2840 2938 2944 812 2829 2882 2902 2930 2940 




}
zebrica = {
	#Canterribean
	227 229 230 368 4150 4548 347 366 1110 484 485 4622 4623 4624 483 486 2654 2655 2656 487 488 489 1881 4618 4619 495 496 497 1113 498 501 1096 1111 499 500 1115 2244 494 1112 2237 
}

europe = {
}

asia = {
	
}

africa = {
	
}

north_america = {
	
}

south_america = {
	
}

oceania = {
	
}

island_check_provinces = {
	
}

# Used for RNW
new_world = {
}